person=pessoa
mouse=mouse
cat=gato
dog=cachorro
bed=cama
clock=relógio
chair=cadeira
table=mesa
bird=pássaro
book=livro
tv=televisão
laptop=notebook
toothblush=escova de dente
refrigerator=geladeira
microwave=microondas
kite=pipa
airplane=avião
car=carro
keyboard=teclado
bottle=frasco
skis=esquis
tennis racket=raquete de tênis
remote=controle remoto
traffic light=semáforo
cell phone=telefone celular
surfboard=prancha de surf
suitcase=mala
apple=maçã
donut=rosquinha
train=trem
sandwich=sanduíche